###################
#@                #
#              x  #
#                 #
#                 #
#         x       #
#                 #
#                 #
###################
